5 2
1:0 1:0 1:0 1:0 1:0 1:0 1:0 1:0 1:0 5:5 0:0 0:1 0:0 0:0 0:0 0:0 0:0 0:1 0:1 0:0 0:0 0:0 0:0 5:7 
1:0 1:0 1:0 1:0 1:0 1:0 1:0 1:0 1:0 5:5 0:0 0:1 0:1 0:0 0:0 0:0 0:0 0:0 0:0 0:0 0:0 0:0 0:0 5:7 
1:0 1:0 1:0 1:0 1:0 1:0 1:0 1:0 1:0 5:5 0:0 0:0 0:1 0:1 0:0 0:0 0:1 0:1 0:1 0:0 0:1 0:0 0:0 5:7 
1:0 1:0 1:0 1:0 1:0 1:0 1:0 1:0 1:0 5:5 0:0 0:0 0:0 0:1 0:0 0:0 0:0 0:0 0:0 0:0 0:0 0:0 0:0 5:7 
1:0 1:0 1:0 1:0 1:0 1:0 1:0 1:0 1:0 5:5 0:0 0:0 0:0 0:0 0:0 0:0 0:0 0:0 0:1 0:0 0:0 0:0 0:0 5:7 
1:0 1:0 1:0 1:0 1:0 1:0 1:0 1:0 1:0 5:5 0:0 0:0 0:0 0:1 0:0 0:0 0:1 0:0 0:1 0:0 0:0 0:0 5:0 1:0 
1:0 1:0 1:0 1:0 1:0 1:0 1:0 1:0 1:0 1:0 5:1 0:0 0:0 0:1 0:0 0:1 0:1 0:0 0:1 0:0 0:0 0:0 5:7 1:0 
1:0 1:0 1:0 1:0 1:0 1:0 1:0 1:0 1:0 1:0 5:5 0:0 0:0 0:0 0:0 0:1 0:0 0:0 0:0 0:0 0:0 0:0 5:7 1:0 
1:0 1:0 1:0 1:0 1:0 1:0 1:0 1:0 1:0 1:0 1:0 5:1 0:0 0:0 0:0 0:0 0:0 0:0 0:0 0:0 0:0 0:0 5:7 1:0 
5:6 5:6 5:6 5:6 5:6 5:6 5:6 5:6 5:6 5:9 1:0 5:5 0:0 0:1 0:0 0:0 0:1 0:1 0:1 0:0 0:0 5:0 1:0 1:0 
0:0 0:0 0:0 0:0 0:0 0:0 0:0 0:0 0:0 5:3 5:9 1:0 5:1 0:0 0:0 0:0 0:0 0:0 0:0 0:0 5:0 1:0 1:0 1:0 
0:1 0:0 0:0 0:0 0:1 0:1 0:0 0:0 0:0 0:0 5:7 1:0 1:0 5:4 6:10 5:4 5:4 5:4 6:10 5:4 1:0 1:0 1:0 1:0 
0:1 0:1 0:0 0:0 0:0 0:1 0:0 0:0 0:0 0:0 5:3 5:6 5:6 5:6 6:11 5:6 5:6 5:6 6:11 5:6 5:6 5:6 5:6 5:6 
0:0 0:0 0:0 0:0 0:0 0:0 0:0 0:0 0:0 0:0 0:0 0:0 0:0 0:0 0:0 0:1 0:1 0:0 0:0 0:0 0:0 0:1 0:1 0:0 
0:0 0:0 0:0 0:0 0:0 0:0 0:0 0:0 0:1 0:1 0:0 0:0 0:0 0:0 0:0 0:0 0:0 0:0 0:0 0:0 0:0 0:0 0:1 0:0